%%%%%%%%%%
%.%%.....%
%.%.%.%%.%
%.%.....%%
%...%....%
%..% %.%.%
%..P%%.%.%
%.%%...%.%
%%%%%%%%%%
